Machine,Job,Product,Operation,Start,Duration,Completion
0,3,enzyme3,0,0,4,4
1,4,enzyme4,0,0,5,5
2,1,enzyme1,0,0,3,3
2,0,enzyme0,0,7,8,15
3,2,enzyme2,0,0,3,3
3,1,enzyme1,1,5,2,7
3,0,enzyme0,1,15,4,19
4,5,enzyme5,0,0,8,8
5,4,enzyme4,1,5,4,9
6,3,enzyme3,1,4,6,10
7,2,enzyme2,1,3,3,6
7,5,enzyme5,1,8,3,11
7,3,enzyme3,2,12,6,18
7,0,enzyme0,2,21,4,25
8,4,enzyme4,2,9,7,16
