Machine,Job,Product,Operation,Start,Duration,Completion
0,1,enzyme1,0,0,3,3
0,0,enzyme0,0,4,8,12
1,3,enzyme3,0,0,4,4
2,4,enzyme4,0,0,5,5
3,2,enzyme2,0,0,3,3
3,1,enzyme1,1,5,2,7
3,0,enzyme0,1,12,4,16
4,5,enzyme5,0,0,8,8
5,4,enzyme4,1,5,4,9
6,3,enzyme3,1,4,6,10
7,2,enzyme2,1,3,3,6
7,5,enzyme5,1,8,3,11
7,4,enzyme4,2,14,7,21
8,3,enzyme3,2,10,6,16
8,0,enzyme0,2,19,4,23
